Level 3
#######
#o.*..#
#X..*.#
#.o...#
#######