Level 8 - by Kazimierz Piontek
###########
#....#o...#
#..*.#.*..#
#.#..##o###
#o####.*..#
#...X.....#
###########