Level 10 - by Kazimierz Piontek
###################
#o......###......o#
#.##..#..#.*#.#.###
#..##..*.#........#
#.....#.....#..####
########.X.########
#...#.#....#...#..#
#.#....*.#.*.#....#
#.#.#....##.....#.#
#o....#########..o#
###################