Level 2 - by Kazimierz Piontek
#######
#.##.o#
#.*...#
#X....#
#######