Level 9 - by Kazimierz Piontkowski
###########
#X........#
#....**...#
#...#o#...#
#...*o#...#
#...#o#...#
###########