#######
#.....#
#X..*.#
#.o...#
#######