Level 5
#####################
#...................#
#...................#
#...................#
#...................#
#..............o....#
#...*...............#
#...................#
#...................#
#...................#
#...................#
#................X..#
#####################