Level 6 - by Kazimierz Piontkowski
###########
#....o....#
#...*.....#
#...**....#
#####o#####
#...#o#...#
#....X....#
###########