Level 3 - by Kazimierz Piontkowski
#######
#..#..#
#X..*.#
#.o...#
#######