Level 5
#########
#....X..#
#.......#
#...**..#
#..#.####
#...oo..#
#########